13,10,,,,,,,,,,,
0,29,29,29,29,29,29,29,35,0,0,0,0
0,-32,-32,-32,-32,-32,-32,-32,34,29,29,30,0
0,15,15,15,15,15,12,12,-33,-32,-32,-31,0
0,15,12,12,12,12,11,11,16,12,12,12,0
0,15,11,11,11,11,11,11,11,11,11,11,0
0,15,28,26,26,26,26,27,11,11,11,11,0
0,15,24,17,17,17,17,20,11,11,11,11,0
0,15,24,17,17,17,17,20,11,11,11,11,0
0,15,23,22,22,22,22,21,11,36,37,11,0
0,0,0,0,0,0,0,0,0,0,0,0,0
